S____WEW\n
_W_W_W_W\n
_W_W_W_W\n
_W_W_W_W\n
___W___W\n